0,0,0,0,0,0,0,0,0,0,0,0,0,0,0,0,0,0,0,0,0,0,0,0,0,0,0,0,0,0,0,0,0,0,0,0,0,0,0,0,0,0,0,0,0,0,0,0,0,0,0,0,0,0,0,0,0,0,0,0,
0,0,0,0,0,0,0,0,0,0,0,0,0,4,4,0,0,0,0,0,0,0,0,0,0,0,0,0,0,0,0,0,0,0,0,0,0,0,0,0,0,0,0,0,0,0,0,0,0,0,0,0,0,0,0,0,0,0,0,0,
1,2,3,2,0,0,0,0,0,0,0,2,2,2,0,0,0,0,0,0,0,0,0,0,0,0,0,0,0,0,0,0,0,0,0,0,0,0,0,0,13,14,15,0,0,0,0,16,16,16,16,0,0,4,0,0,3823,3824,0,4,
5,6,6,7,0,4,0,2,2,2,0,0,0,0,0,0,0,0,2,2,2,0,0,16,16,16,0,0,16,16,16,0,0,16,16,16,0,16,0,16,0,0,0,0,0,0,0,0,0,0,0,0,0,8,0,1,2,3,0,8,
5,6,6,7,0,4,0,0,6,0,0,0,0,0,0,0,0,5,6,6,6,3,0,0,0,0,0,0,0,0,0,0,0,0,0,16,0,0,0,0,0,0,0,0,0,0,0,0,0,0,0,0,0,12,0,5,6,7,0,12,
5,6,6,7,0,4,0,0,0,0,13,14,15,0,0,0,16,5,6,6,6,3,0,0,0,0,0,0,0,0,0,7,0,0,0,0,16,16,1,2,3,1,2,3,4,0,0,0,0,1,2,3,0,0,0,9,10,11,0,0,
9,10,10,11,0,0,0,0,0,0,0,0,0,0,0,16,0,0,0,0,0,0,0,0,0,0,0,0,3823,3824,0,7,0,0,0,0,0,0,5,6,7,5,6,7,8,0,4,0,0,5,6,7,0,0,0,0,0,0,0,0,
0,0,0,0,0,0,0,0,0,0,0,0,0,13,14,15,0,14,14,14,14,14,14,0,0,16,16,16,16,16,16,16,0,16,16,16,16,0,9,10,11,9,10,11,12,0,8,0,0,9,10,11,0,0,0,0,4,0,0,0,
0,3823,3824,0,0,4,4,0,4,4,4,0,0,0,0,0,0,0,0,0,0,0,0,0,0,0,0,0,0,0,0,0,0,0,0,0,0,0,0,0,0,0,0,0,0,0,12,0,0,0,0,0,0,0,0,0,8,0,0,0,
13,14,15,0,0,6,0,0,0,0,0,0,0,0,0,0,0,0,0,0,0,0,0,0,0,0,0,0,0,0,0,0,0,0,0,0,0,0,0,0,0,0,0,0,0,0,0,0,0,0,0,0,13,14,15,0,12,0,0,0,
0,0,0,0,0,0,0,0,0,0,0,0,0,0,0,0,0,0,0,0,0,0,0,0,0,0,0,0,0,0,0,0,0,0,0,0,0,0,0,0,0,0,0,0,0,0,0,0,0,0,0,0,0,0,0,0,0,0,0,0